|            |   |                      |
|            |   |        +-------+     |
|        |   |   |        |       |     |
|        |   |   | -------+ +---- |     |
|        |       |        | |     |     |
|        | ------+----+-  | |   | |     |
|        |       |    |   | |   | |     |
|  ------+------ | |  | +-+-+ | | |     |
|        |       | |  | |   | | | |     |
|        |   |   | |  | |   | | | |     |
|        |   |   | |  | |   | | | |     |
|        |   |     |          | | |     |
|    |   |   |  ---+--------- | +-+--   |
|    |       |        |   |   |         |
|    | ------+--+---  | | |   |         |
|    |       |  |     | | |   |         |
|    |       |  | |   | | |   |         |
|----+------ |  | |   | | |   |  |      |
|    |       |  | |     |        |      |
|    | |     |  | | ------+----- |      |
|    | |          |       |      |      |
|    | |    ---+--+--+ ---+      |      |
|    | |       |     |    | -----+----  |
|      +------ |  |  +--- |      |      |
|      |          |       |      |      |